!........!
###....###
..........
!........!
###....###
.......#.!
!......#..
###....#..
..........
....@.....