!#!!#!...!
.##....###
.........!
.#.##..#..
!#.!#..#..
##!.#..#!!
#####..###
!.........
#########.
@.........