!.!.!..!.!
!.!.!..!.!
!.!.!..!.!
..........
..........
..........
!........!
####..####
..........
@.........