!.!.!..!.!
!.!.!..!.!
!.!.!..!.!
!.!.!..!.!
##......##
!....!....
!....!....
#######...
@.........
..........