!........#
#####...##
!.!#...###
#.....####
!........!
##.#....##
!..#.....!
##.#....##
!..#..####
#####....@