!....!.!#!
!......!#.
##..#####.
!........
#......!#
!.....####
###......
....!!....
.########.
....@....